1,1,1,1,1,1,1,1,0,0,0,0,0,0,0,0,0,0,0,0,0,0,0,0,0,7,1
1,1,1,1,1,1,1,0,0,0,0,0,0,0,0,0,0,0,0,0,0,0,0,0,0,7,1
1,1,1,1,1,1,1,0,0,0,0,0,0,0,0,0,0,0,0,0,0,0,0,0,0,7,1
1,1,1,1,1,1,0,0,0,0,4,2,2,2,2,2,2,2,2,2,2,2,2,3,0,7,1
1,1,1,1,0,0,0,0,0,0,7,1,1,1,1,1,1,1,1,1,1,1,1,1,0,7,1
1,0,0,0,0,0,0,0,0,0,7,1,0,0,0,0,0,0,0,0,0,0,5,1,0,7,1
1,0,0,0,0,0,0,0,0,0,7,1,0,0,0,0,0,0,0,0,0,0,0,0,0,7,1
1,0,0,0,0,0,4,2,2,2,6,1,0,0,0,0,0,0,0,0,0,0,0,0,0,7,1
1,0,0,0,0,0,5,1,1,1,1,1,0,4,2,2,2,2,2,2,2,2,3,0,0,7,1
1,0,0,0,0,0,0,0,0,0,0,0,0,7,1,1,1,1,1,1,1,1,1,0,0,7,1
1,0,0,0,0,0,0,0,0,0,0,0,4,6,1,1,1,1,1,1,1,1,1,0,0,7,1
1,0,0,0,0,0,0,0,0,0,0,4,6,1,1,1,1,1,1,1,1,1,1,0,0,7,1
1,0,0,0,0,0,0,0,0,0,0,5,1,1,1,1,1,1,1,1,1,1,1,0,0,7,1
1,0,0,0,0,0,0,0,0,0,0,0,0,7,1,1,1,1,1,1,1,1,1,0,0,7,1
1,2,2,2,2,2,2,2,2,3,0,0,0,5,1,1,1,1,1,1,1,1,1,0,0,7,1
1,1,1,1,1,1,1,1,1,1,0,0,0,0,7,1,1,1,1,1,1,1,1,0,0,7,1
0,0,0,0,0,0,0,0,7,1,0,0,0,0,7,1,1,1,1,1,1,1,1,2,2,6,1
0,0,0,0,0,0,0,0,7,1,0,0,0,0,7,1,1,1,1,1,1,1,1,1,1,1,1
0,0,0,0,0,0,0,0,7,1,0,0,0,0,7,1,1,1,1,1,1,1,1,1,1,1,1
0,0,0,0,0,0,0,0,7,1,0,0,0,0,7,1,1,1,1,1,1,1,1,1,1,1,1
0,0,0,0,0,0,0,0,7,1,2,2,2,2,6,1,1,1,1,1,1,1,1,1,1,1,1
0,0,0,0,0,0,0,0,7,1,1,1,1,1,1,1,1,1,1,1,1,1,1,1,1,1,1
